NO maps/wall_blue.tga
SO maps/wall_red.tga
WE maps/wall_green.tga
EA maps/wall_yellow.tga

C 34, 34, 34
F 72, 59, 58

         111111
         100001
         100000111 1111111111
         100000001 10010010011111
         100000101110010010010001
         100001101000000000000001
         111111101000000000010001
               101110000001111111
               10100000000001
               10100000000001
    11111111   10111000000111
    10000001   10100000000001        111111111111
    10000001   101000000000011111111100000000000111111
    10000001   1011100000011110000000011111110000000001
    10000001   101  110011   100000000111111100000000001
    10000001   101  100001   1000011100000000000100000001
    1000000111110111100001   100001  11111111111100000001
    1110011110000000100001   100001             100000001
    1000000110000000100001   100001             10000001
11111000000110011100100001111100001             1000001
10E00001100000011100000000000111001             111111
10000001100000011100000000000000001
11111000000110011100100000000111111
    10000001100000001111111111
    11111111100000001
            111101111
                1
