NO maps/wall_blue.tga
SO maps/wall_red.tga
WE maps/wall_green.tga
EA maps/wall_yellow.tga

C 34, 34, 34
F 72, 59, 58

     11111
     10001
     10S01
     10001
1111 11011 1111
1001  101  1001
100111101111001
100000000000001
100111101111001
1001  101  1001
1111  101  1111
       1
